

EA ./assets/textures/barrel.xpm
NO ./assets/textures/barrel.xpm                

WE ./assets/textures/barrel.xpm   



SO ./assets/textures/barrel.xpm
C 204,255,229

F 0,0,102


1111111111111
1111111111111
1010000101001
1010N00101001
1010000101001
1000000000001
1000010101001
100000010101
1111111111111
1111111111111