

EA ./assets/textures/barrel.xpm
NO ./assets/textures/barrel.xpm                

WE ./assets/textures/barrel.xpm   



SO ./assets/textures/barrel.xpm
C 0,5,214

F 1,1,1



11111111111111111111
10100000000000000001
10100000000100010001
10100000000100010001
10000000000100010001
10000100010101010101
1000S000000100010001
11111111111111111111
