

C       0, 255 ,   255

F 128 ,128,128


C       0, 255 ,   255
              EA ./textures/wood.xpm              

NO             ./textures/barrel.xpm                  

WE ./textures/redbrick.xpm    




SO           ./textures/greystone.xpm



            1111111111111111111111111                       
            1000000000110000000111111
      11111110001110000000000001
      1001000000000000000000001
111111111011000001110000000000001
100000000011000001110111111111111
11110111111111011100000010001
11110111111111011101010010001
11000N00110101011100000010001
10000000000000001100000010001
10000000000000001101010000001
110000011101010111110111100111
11110111 1110101 111111010001
11111111   1101111     111111111111
      1111111101111111111111111
      1000000000110000000000001
      1011000001110000000000001
      1001000000000000000000001
111111111011000001110000000000001
100000000011000001110111111111111
11110111111111011100000010001
11110111111111011101010010001
11000000110101011100000010001
10000000000000001100000010001
10000000000000001101010000001
110000011101010111110111100111
11110111 1110101 101111010001
11111111 1111111 111111111111
