

EA assets/textures/barrel.xpm     
NO assets/textures/barrel.xpm                  

WE assets/textures/redbrick.xpm    



SO assets/textures/greystone.xpm
C 0,5,214

F 1,1,1

1111111111111111111111111111111111111111111111111111111111111111111111111111
100E011111111111111111111111111111111111111111111111111111111111111111111111
1010000000000000000000000000000000011111111111111111111111111111111111111111
1010000000000000000000000000000000011111111111111111111111111111111111111111
1010000000000000000000000000000000011111111111111111111111111111111111111111
1010000000000000000000000000000000011111111111111111111111111111111111111111
1010000000000000000000000000000000011111111111111111111111111111111111111111
1011111111111111111111111111111111111111111111111111111111111111111111111111
1000000000000000000000000000000000000000000000000000000000000000000000000011
1111111111111111111111111111111111111111111111111111111111111111111111111111