












EA /Users/heltayb/Desktop/test_cube/assets/textures/barrel.xpm     
NO /Users/heltayb/Desktop/test_cube/assets/textures/barrel.xpm                  

WE /Users/heltayb/Desktop/test_cube/assets/textures/redbrick.xpm    

C 0 ,   -25 ,1

F 255,125,125

SO     /Users/heltayb/Desktop/test_cu/assets/textures/greystone.xpm


1111111111
10000000011111
1000000001
1111111111
10000000111111
11111111E111111111111
11111111111