












              EA /Users/heltayb/Desktop/test_cube/assets/textures/wood.xpm              
NO             /Users/heltayb/Desktop/test_cube/assets/textures/barrel.xpm                  

WE /Users/heltayb/Desktop/test_cube/assets/textures/redbrick.xpm    

C       0,255,255

F 0, 125,        125

SO /Users/heltayb/Desktop/test_cu/assets/textures/greystone.xpm


1111111111
1000000001
1000000001
1111111111
          1
1111111111
1000000001
11111111S1
1111111 1