

EA ./assets/textures/barrel.xpm
NO ./assets/textures/barrel.xpm                

WE ./assets/textures/barrel.xpm   



SO ./assets/textures/barrel.xpm
C 204,255,229

F 0,0,102


1111111
1111111
1010001
1010N001
10000001
1111111