NO textures/greenlight.xpm
WE textures/bluestone.xpm
SO textures/colorstone.xpm
EA textures/eagle.xpm
F 0,60,100
C 150,150,150

111111111111111111111111111
1S1000111110000000000000001
101010000010000000000000001
100010111000000000000000001
111111111111111111111111111