

EA                           /Users/heltayb/Desktop/test_cube/assets/textures/barrel.xpm     
NO /Users/heltayb/Desktop/test_cube/assets/textures/barrel.xpm                  

WE /Users/heltayb/Desktop/test_cube/assets/textures/redbrick.xpm    

C 0,5,214

F 25,6,12

SO /Users/heltayb/Desktop/test_cu/assets/textures/greystone.xpm

111
11            1
1101
11E1
1111