

EA ./assets/textures/barrel.xpm
NO ./assets/textures/barrel.xpm                

WE ./assets/textures/barrel.xpm   



SO ./assets/textures/barrel.xpm
C 0,5,214

F 1,1,1


11111111
11111111
10100001
1010S001
10100001
10000001
10000101
10000001
11111111
11111111