

EA assets/textures/barrel.xpm     
NO assets/textures/barrel.xpm                  

WE assets/textures/redbrick.xpm    



SO assets/textures/greystone.xpm
C 0,5,214

F 1,1,1

1111
10E1
1111