

EA ./assets/textures/barrel.xpm    
NO ./assets/textures/barrel.xpm                  

WE ./assets/textures/barrel.xpm   



SO ./assets/textures/barrel.xpm
C 0,5,214

F 1,1,1



11111 1111   1111111111111111111
1000011111   11111111111111111
1010000001111000000N111111111111 1111
101000000111100000001111111111
10100000000000000000111  11111
101000000111100000001111111111
101000000111100000001111111111
111111111111111111111111111111
