

EA assets/textures/barrel.xpm     
NO assets/textures/barrel.xpm                  

WE assets/textures/redbrick.xpm    



SO assets/textures/greystone.xpm
C 0,5,214

F 1,1,1

111111111111111111111111
100001111111111111111111
1010000001111000000E1111
101000000111100000001111
101000000000000000001111
101000000111100000001111
101000000111100000001111
101111111111111111111111
100000000000000000000011
111111111111111111111111