

EA ./assets/textures/barrel.xpm
NO ./assets/textures/barrel.xpm

WE ./assets/textures/barrel.xpm



SO ./assets/textures/barrel.xpm
C 204,255,229

F 0,0,102


111111111111111111111111111111
100000000000000000000000000001
101000000000000000000000000001
100000000000000000000000000001
10N000000000000000000000000001
100000000000000000000000000001
111111111111111111111111111111
