

EA                           /Users/heltayb/Desktop/test_cube/assets/textures/barrel.xpm     
NO /Users/heltayb/Desktop/test_cube/assets/textures/barrel.xpm                  

WE /Users/heltayb/Desktop/test_cube/assets/textures/redbrick.xpm    

C 0,5,214

F 25,6,12

SO /Users/heltayb/Desktop/test_cu/assets/textures/greystone.xpm
11111
1 1 1 1 1 1  1111111
1111111111111111111E1
1 11111 1 1111111110111   
111 1 1111111 11111111
1111111111  111111111
11111111111111111111111111111111111111
111111111111111011111
11111111111 1111111
111111111111111111101                    
11 1111111111  1110111
111111111111 1111111
1111111   111111111111
11111111111111111111111111111111111111