

EA ./assets/textures/barrel.xpm
NO ./assets/textures/barrel.xpm                

WE ./assets/textures/barrel.xpm   



SO ./assets/textures/barrel.xpm
C 204,255,229

F 0,0,102


11111111111111
1S001000100001
10100010001011
11111111111111