

EA ./assets/textures/barrel.xpm
NO ./assets/textures/barrel.xpm                

WE ./assets/textures/barrel.xpm   



SO ./assets/textures/barrel.xpm
C 0,5,214

F 1,1,1



     111111111111111111111
111110000000000001
1S1000000001000101
101000000001000101
100000000001000101
100001000101010101
100000000001000101
111111111111111111
