

EA ./assets/textures/barrel.xpm
NO ./assets/textures/barrel.xpm                

WE ./assets/textures/barrel.xpm   



SO ./assets/textures/barrel.xpm
C 0,5,214

F 1,1,1


11111111
111111S1
10100101
10100101
10000101
10000101
10000101
11111111