




              EA ./textures/wood.xpm              

NO             ./textures/barrel.xpm                  

WE ./textures/redbrick.xpm    

C       0, 255 ,   255



SO           ./textures/greystone.xpm

F 0,125,125

1111111111111111111111111111111111
111111111111000110000000111111
11111 11110111000000000001
1111111111111110111000001111111
110000001101010111000000111
1000000000000000110000001
1000000000000000110101001
1111011111111101110101001
1100000111010101111101111
1111110111111110101110111101
111111111111111111111111111111111
