

EA assets/textures/barrel.xpm     
NO assets/textures/barrel.xpm                  

WE assets/textures/redbrick.xpm    



SO assets/textures/greystone.xpm
C 0,5,214

F 1,1,1

11111111
1E000001
10000001
10000001
10000001
10000001
10000001
10000001
11111111