

EA ./assets/textures/barrel.xpm
NO ./assets/textures/barrel.xpm                

WE ./assets/textures/barrel.xpm   



SO ./assets/textures/barrel.xpm
C 0,5,214

F 1,1,1


11111111 1 111
10100001 1 1001
1010S001 1 1001
10100001 1 1001111111
10000001 1 1001
10000101 1 1001111111
10000001 1 1001
11111111 1 1111